  0123456789
0 |--------|
1 |.F.|..-.|
2 |..-|.@..|
3 |..F...-.|
4 |--------|